111111
100C01
1EP001
1C0001
100001
111111