111111111
10ECP0001
100000001
111111111
