1111111111
1ECP00001
1111111111