1111111
11C1EP1
1101001
1111111